8 8
0 0
.......X
.X......
........
.......X
.X......
........
........
....X...
  1   1 100 100 100 100   1 100
  1 100 100   1 100 100   1 100
  1 100 100   1 100 100   1 100
  1 100 100   1 100 100   1 100
  1 100 100   1 100 100   1 100
  1 100 100   1 100 100   1 100
  1 100 100   1 100 100   1 100
100 100 100   1 100   1   1 100
